W W W W W W 
W S 0 0 1 W 
W 1 1 b 1 W 
W 1 1 c 0 Z 
W c 0 0 0 W 
W W w W W W 