W W W W W W W W 
W 0 0 m 0 1 0 W 
W S 1 0 1 1 0 W 
W 1 1 c 0 0 0 Z 
W c 0 0 0 1 0 W 
W W w W W W W W 
